11111
10001
10P01
10C01
10E01
11111