1111111111111111
1000000000000001
1011100P00000001
101C10000000C001
1010100E00000001
1000000000000001
1111111111111111