111111111111111111111111111111
10000000000000P000000000000001
101111111111111111111111111101
1000000000000001E0000000000001
100000000000000101000000000001
100000000000000111111111111101
1000000000000001C0000000000101
100000000000000111111111110101
100000000000000000000000010101
100000000000000000000000010101
100000000000000000000000010101
100000000000000000000000010101
100000000000000000000000010101
100000000000000000000000010101
100000000000000000000000010101
1000000000000X0000000000010101
100000000000000000000000010101
1000000000000000000000000001C1
111111111111111111111111111111